7
10
OXXXXXXXXX
OOOOOOOOOO
OXOXOXOXXX
OXOXOXOOOO
XXOXXXOXXX
XOOOOOOOXX
XXXXXXXOOOZ